10
1 0 0 0 0 0 0 4 4 4
4 0 0 4 4 0 0 0 0 3
0 0 0 4 4 0 2 0 0 0
0 0 0 0 0 0 0 0 0 0
0 3 0 0 0 0 4 0 0 4
0 0 2 0 0 0 0 0 0 4
0 0 4 4 4 4 4 0 0 0 
0 0 0 0 4 0 0 0 0 0
0 0 0 0 4 3 0 0 0 4
2 0 0 0 0 0 0 0 0 4